NO test/textures/north.xpm
SO test/textures/south.xpm
WE test/textures/west.xpm
EA test/textures/east.xpm

F 220,100,0
C 100,200,255

111111111111
100011000011
10S01100001111111
10000000000000001
11111110001111111
     1100011                     1111
     1100011111111111111        11001
     1100000000000000011       110001
     1111111111111100011      1100001
                 11000111111111000011
                 11000000000000001111
                 11111111111111111111
