NO test/textures/north.xpm
SO test/textures/south.xpm
WE test/textures/west.xpm
EA test/textures/east.xpm

F 220,100,0
C 100,200,255

11111
10001
10S01
10001
11111
