NO ./textures/grey_stone.xpm
SO ./textures/grey_stone.xpm
WE ./textures/grey_stone.xpm
EA ./textures/grey_stone.xpm

F 220,100,0
C 225,30,0

111111111111111111111111111111
100000000000000000000000000001
100000000000000000000000000001
100000000000000000000000000001
100000001000000000001000000001
100111110000000000000111111001
100000000000000000000000000001
100000000000000000000000000001
100000000000001000000000000001
100000000000001000000000000001
100000000000000000000000000001
100000000000000000000100000001
100000000000000000001000000001
100000000000111111110000000001
100000000000000000000000000001
10N000000000000000000000000001
111111111111111111111111111111